111111111111111110
000000000000000001
100000000000000001
1CCC00000000000001
100000000000000001
100011110000000001
1P0000000000000001