111111111111111111
1P0000100000000C01
10111010111111P101
101000101000010101
101010101010110101
1010101C1010000101
101010101011111101
1010101E1000000101
101010111111110101
101010000000010101
101011111111110101
1C0000000000000C01
111111111111111111
