111111111111111111
10000000000000CCC1
100000000000001111
100000000C00011001
100000101110000001
10P0101000000000E1
111111111111111111
