111111111111111111
100000000000000001
100000000000000CC1
100000000000001111
100000100011000001
10P0101000000E0001
111111111111111111
