11111111111111111111111111111111111111111
1P0000100000000C0000000000000000000000001
10111010111111010000000000000000000000001
10100010100001010000000000000000000000001
10101010101011010000000000000000000000001
1010101C101000010000000000000000000000001
1010101010111111000000000000000P000000001
1010101E100000010000000000000000000000001
10101011111111010000000000000000000000001
10101000000001010000000000000000000000001
10101111111111010000000000000000000000001
1C0000000000000C0000000000000000000000001
11111111111111111111111111111111111111111
