111111111111111111
100000000000000001
100000000000000CC1
100000000000001111
100000100011000000
10P0101000000E0000
111111111111111111
